1111111111111111111111111111111
1E00S00S0S1S000S10S00S00000S0E1
11SS111110111110111111111111001
11S1111110111110111111111111101
1P000S100S00S00S00S000S00S000S1
1111111111111111111111111111111
