1111111111111111111111111111111
1E00C00C0C1C000C10C00C00000C0E1
11C1111110111110111111111111001
11C1111110111110111111111111101
1P000C100C00C00C00C000C00C000C1
1111111111111111111111111111111
